###########################%#
#.....#...#.#.#...#.........#
####..#.#.#...#...#.###.#####
#..##...#.#.###.#...#.......#
#.##@..####..#...##########.#
#.#...#.#..####..#..#...#...#
#.###...##....##.##.#.#.#.#.#
#........#...##.....#.#...#.#
##.##.##...#....#.#####.###.#
#...##.#.########..#.#...#..#
##.##..#....#...#.##.###.##.#
#..#..####.###.......#....#.#
#........#.#.##...#.##..###.#
#####.####.#..###.###..##.#.#
#.....#......##....#..##....#
#.##.######...#..###...######
#..#......#..##..#.##...#...#
######.#####.#..##..##..##..#
#....#.....#.#...#...##..##.#
#....#.########.##....##....#
####.#.#...#....#..##..##...#
#....#.#.######.####....##..#
#..#...#...#..#......##..##.#
#..######.##.##.###..#....###
#.......#.....#.#.#####..##.#
#####.#.#.#.#.#.#.#..#..##..#
#.....#.#.#.#.#.#.##.##.....#
#.....#...#.#...#...........#
#############################